XXXXXXXXXXXXXXXXXXXXXXXXXXXXXXXX
XXXXXXXXXXXXXXXXXXXXXXXX     XXX
XX        XXXXXXXXXXXXXX  1  XXX
XX    d1  XXXXXXXXXXXXXX     XXX
XX  d d d XXXXXX      XXXXdXXXXX
XXXX  XXXXXXXXXX  d  d  d  XXXXX
XXXX  XXXXXXXXXX      XXXXXXXXXX
XXO   XXXXXXXXXXXXOOXXXXXXXXXXXX
XX OXXXX Z  Z   XXOOXXXXXXXXXXXX
XXO XXXX  Z   Z     XXXXXXXXXXXX
XX OXXXX        XXXXXX Z Z XXXXX
XX    XXXXXXX XXXXXXXX ZZ  XXXXX
XX    XXXXXXX XXXXXXXX     XXXXX
XXXX  XXXXXX       XXX     XXXXX
XXXX  XXXXXX               XXXXX
XXX      XXX   S   XXXX   XXXXXX
XXX                XXXX   XXXXXX
XXX      XXX       XXXX      XXX
XXX  ZZ  XXXXXXX XXXXXX   XX XXX
XXX Z  Z XXXXXXX XXXXXXXXXXX XXX
XXX      XXXXXXX    XXXXX  O  XX
XXXXXXXXXXXX  XX    XXXXX O O XX
XXXXXXXXXXXX    ZZZZXXXXXO    XX
XX     XXXXX  XXXXXXXXXXXXX  XXX
XXd 1d XXXXX  XXXXXXXXXXXXX  XXX
XX d d XX          XXXXXXXX  XXX
XX     XX   O   O  XXXXX   d  XX
XXX   XXX  O  O    XXXXX d  d XX
XXX   XXXXXXXXX  XXXXXXX  1  dXX
XXX              XXXXXXX      XX
XXX              XXXXXXXXXXXXXXX
XXXXXXXXXXXXXXXXXXXXXXXXXXXXXXXX
