XXXXXXXXXXXXXXXXXXXXXXXXXXXXXXXX
XXXXXXXXX XXXXXXXXXXXXXXXXXXXXXX
XXXXX XX  XXXXXXXXXXXXX  XXXXXXX
XXX        XXXXXXXXXX  S   XXXXX
XXX   XX   XXXXXXXXXX X   XXXXXX
XXX   XX   XX   XXXX     XXXXXXX
XXX        XX B XXXX      XXXXXX
XXX      Z      XXXXX    XXXXXXX
XXXXXX B   O  XXXXXXX      XXXXX
XXXXXX   XX   XXXX O     B XXXXX
XXXXXX   XX         B Z Z XXXXXX
XXXX       B  XXXX    XXXXXXXXXX
XXX  O     XXXXXX  Z     XXXXXXX
XXXXX B X  XXXXXXX    X  XXXXXXX
XXXXX  X   XXXX  X  X O  XXXXXXX
XXX        XX            XXXXXXX
XXX   XXXXXXX   O     XXXXXXXXXX
XXX   XXXXXXX     XXXXXXXXXXXXXX
X   B   O XXX   Z XXXXX     XXXX
X    Z    XXX     XXXXXB   O  XX
X    X B      B   XXXXX  B    XX
X            X          XXX   XX
XXXXXXXXX    X   O B    XXXXXXXX
XXXXXXXXXXX   Z  XXX     XXXXXXX
XXXXXX XXXX B   XXX   Z  XXXXXXX
XXX         Z   XXX B O XXXXXXXX
XX  D XX O    B XXXX  X    XXXXX
XXX   XX  B   XXXXXX    B  XXXXX
X         X   XXXXXXXXX   XXXXXX
XXX    X    XXXXXXXXXXXXXXXXXXXX
XXX         XXXXXXXXXXXXXXXXXXXX
XXXXXXXXXXXXXXXXXXXXXXXXXXXXXXXX
