XXXXXXXXXXXXXXXXXXXXXXXXXXXXXXXX
XXXXXXXXXXXXXXXXXXXXXXXXXXXXXXXX
XXXXXX    XXXXXXXXXXXXXXXXXXXXXX
XXXX   D   XXXXXXXX      XXXXXXX
XXXX            Z   O XX  XXXXXX
XXXX  X      ZO  O     X  XXXXXX
XXXXX  Z   XXXXXXXX       XXXXXX
XXXXXXXXXXXXXXXXXXX  O    XXXXXX
XXXXXXXXXXXXXXXX    Z    XXXXXXX
XXXXXXXXXXX   XX  Z  O   XXXXXXX
XXXXXXXXXX      O      XXXXXXXXX
XXXXXXXX O     Z   O  XXXXXXXXXX
XX  XXX     X        XXXXXXXXXXX
X    XX  O  O XXXXXXXXXXXXXXXXXX
X      O  X   XXXXXXXXXXXXXXXXXX
X   Z   Z XZ  XXXX    XX     XXX
X ZOZXXX     XXXX             XX
X   ZXXXXXXXXXXXX Z        X  XX
X  Z    XXXXXX     Z  XX      XX
X    Z  Z   O  O  Z  XXXZZZZZZXX
X   X  O      O   XXXXXX  X   XX
XX   Z  XXXXXXXXXXXXXXXXOOOOOOXX
XXX    XXXXXXXXXXXXXXXXX    X XX
XXXXXXXXXXXXXXXXXXX  O   O    XX
XXXXXXXXXXXXXXX     Z  Z     XXX
XXXX        XXO      Z   Z   XXX
XX          XX    XXXX      XXXX
XX     XX Z     O XXXXXX   XXXXX
XX    XXX    X    XXXXXXXXXXXXXX
XX S  XXXX    Z XXXXXXXXXXXXXXXX
XXXXXXXXXXXXXXXXXXXXXXXXXXXXXXXX
XXXXXXXXXXXXXXXXXXXXXXXXXXXXXXXX
