XXXXXXXXXXXXXXXXXXXXXXXXXXXXXXXX
XXXXXXXXXXXXXX  B  XXXXXXXXXXXXX
XXXXXdd   XXXX     XXXX   ddXXXX
XXXXXdd  B      B      B  ddXXXX
XXXXXdd                   ddXXXX
XXXXXXXXXXXXXX  B  XXXXXXXXXXXXX
XXXXXdd   XXXX     XXXX   ddXXXX
XD   dd  B      B      B  ddXXXX
XXXXXdd                   ddXXXX
XXXXXXXXXXXXXX  B  XXXXXXXXXXXXX
XXXXXdd   XXXX     XXXX   ddXXXX
XXXXXdd  B      B      B  ddXXXX
XXXXXdd                   ddXXXX
XXXXXXXXXXXXXX  B  XXXXXXXXXXXXX
XXXXXdd   XXXX     XXXX   ddXXXX
XXXXXdd  B      B      B  ddXXXX
XXXXXdd                   ddXXXX
XXXXXXXXXXXXXX  B  XXXXXXXXXXXXX
XXXXXdd   XXXX     XXXX   ddXXXX
XXXXXdd  B      B      B  ddXXXX
XXXXXdd                   ddXXXX
XXXXXXXXXXXXXX  B  XXXXXXXXXXXXX
XXXXXdd   XXXX     XXXX   ddXXXX
XXXXXdd  B      B      B  ddXXXX
XXXXXdd                   ddXXXX
XXXXXXXXXXXXXX  B  XXXXXXXXXXXXX
XXXXXdd   XXXX     XXXX     XXXX
XXXXXdd  B      B           XXXX
XXXXXdd                    SXXXX
XXXXXXXXXXXXXX     XXXXXXXXXXXXX
XXXXXXXXXXXXXX     XXXXXXXXXXXXX
XXXXXXXXXXXXXXXXXXXXXXXXXXXXXXXX
